11111111111111111111
1001111E111111000111
1000110P001110000011
1C000100000110C10001
111000000C0111110001
11100000011111000011
11000C10001110000111
10000110000100011111
11000000000000110001
111C1111000000000C01
11111111111111111111