111111111111111111111
11111000000000C1E1111
1111000001100011P0001
111000001100001100001
110000C11000011110001
100000110000111111001
100001100000011110001
1C001100000C001100C01
111110001111000000101
1110000C0001111111111
111111111111111111111